<!DOCTYPE html>
<html lang="es_MX">
<head>
  <meta charset=utf-8>
  <meta name=viewport content="initial-scale=1, minimum-scale=1, width=device-width">
</head>
<body>
<center>
<pre style="font: 10px/5px monospace;">                                                                            
                          `..`                ```                           
                       `;'''''':            ;;;;;'':                        
                      ;''''''''''         `;;;;;;;;'':      .,`             
           `.````    ''''''''''''+`      .;;;;;;;;;''''    ;;''+.           
          ...````   ;'''''''''''''+`    ,;:;;;;;;;;'''',  :;;'''':          
         .....````  ''''''''''''''''`  ,::;;;;;;;;;;''''  ;;;''''',         
        ........``  ;''''''''''''''''.,::;;;;;;;;;;;''':  ;;;'''''+`        
       `,,,......   .''''''''''''''''';:;;;;;;;;;;;;'''   :;;''''''+        
       ,,,,,.....    ;''''''''''''''''';;;;;;;;;;;;'''.   .;;''''''''       
      ,,,,,,,...`     '''''''''''''''''';;;;;;;;;;;'''     :;''''''''.      
     `:,,,,,,,..      ,'''''''''''''''''';;;;;;;;;;''       ;''''''''+      
     :::,,,,,,,        ;'''''''''''''''''';;;;;;;;'',       `''''''''',     
    `:::::,,,,  `...`  `''''''''''''''''''';;;;;;;''  .:;;,  .''''''''+     
    :::::::,,` ,,....`` ,''''''''''''''''''';;;;;'' `::;;;;', :'''''''',    
   `;:::::::. ,,,,...``` ;''''''''''''''''''';;;'',`::;;;;;'': ''''''''+    
   :;::::::: ,:,,,....``` '''''''''''''''''''';''' :::;;;;;'''.`''''''''`   
   ;;;::::: .::,,,,....`` .'''''''''''''''''''''' `::;;;;;''''+`,''''''''   
  .;;;;:::. :::,,,,,...``  :''''''''''''''''''''. .::;;;;;'''''' ;''''''+   
  :;;;;;;: :::::,,,,....`  `''''''''''''''''''''  ,:;;;;;'''''''. '''''''`  
  ;;;;;;;`.;:::::,,,,...`  '''''''''''''''''''''; .;;;;;;'''''''+ :'''''',  
  ;;;;;;: ;;;::::,,,,.... ;''''''''''''''''''''''. ;;;;;'''''''''; '''''';  
  ';;;;; ,;;;:::::,,,,.. ,''''''''''''''''''''''''`,;;;''''''''''+`,''''''  
  '';;;: ;;;;;::::,,,,.``'''''''''''''''''''''''''+ ;;;'''''''''''' ''''''  
  ''';' ,;;;;;:::::,,,. '''''''''''''''''''''''''''' ;''''''''''''+`:''''+  
  ''''' '';;;;;::::,,, ;'''''''''''''''''''''''''''',`'''''''''''''; '''''  
  '''',.'';;;;;:::::: ,''''''''''''''''''''''''''''++`,''''''''''''+ '''';  
  ;''' ;''';;;;;::::``''''''''''''''''''''''''''''++++ ;''''''''''''.:''',  
  :''' '''';;;;;:::, ;''''''''''''''''''''''''''++++++: '''''''''''''`'''`  
  ,'''.''''';;;;;:: :''''''''''''''''''''''''''++++++++`.'''''''''''+ ''+   
   '',;''''';;;;;;``+'''''''''''''''''''''''''+++++++++# :''''''''''' ''+   
   ''`''''''';;;;, ''''''''''''''''''''''''''+++++++++++: ''''''''''',;':   
   :'`''''''';;;; ,'''''''''''''''''''''''''+++++++++++++`.'''''''''';:'`   
   `+`'''''''';;. ''''''''''''''''''+`:'''++++++++++++++++ ;''''''''';:+    
    '`'''''''';' :+''''''''''''''''',  ;'+++++++++++++++++``''''''''':;:    
    ,,;''''''''. ++++++'''''''''''';    '++++++++++++++++++ ;''''''''`'     
     '.'''''''' :+++++++++++'''''''     `++++++++++++++++++``'''''''+ '     
     : '''''''. '+++++++++++++++++       .+++++++++++++++++: ;'''''':``     
      `.'''''+  +++++++++++++++++         ,++++++++++++++++# .'''''+ ,      
        :'''':  ++++++++++++++++`          :+++++++++++++++#  ''''+`        
         ,''+   '++++++++++++++,            ;++++++++++++++;  ,'''`         
           `    :+++++++++++++;              '+++++++++++++`   ``           
                 '+++++++++++'                ++++++++++++;                 
                 `+++++++++++                 `++++++++++'                  
                   '++++++++                   ,++++++++;                   
                    ,'++++'`                    ,+++++;`                    
                       ``                          `                        
                                                                            
                                                                            
                                                                            
                                                                            
               `,.   .,`  .::,    ,:`     .;;   ,;,`';.  ';,.;.             
               .:.   .:. :::::,   :::     ,'', .'': .''`;'; :':             
               .:.   .:.`::  .   ,::;     ,'''.''':  :''''  `:`             
               .:.   .:.,:` ::;  :;`:,    ,';''';':   ;''                   
               .:.   .:..:, ,:; .::.:;    ,';.',,':  ,''''                  
               .:,,,,.:. ::,`:; ::::::.   ,'; . ,': `''.'';                 
               .:::::.:. `::::,`::   ::   ,';   ,': '': `'',                
                           ``                                               
                                                                            
</pre>
<p style="color:navy;font-size:21px;">No se puede encontrar la página web solicitada</p>
<a href="/" style="color:green;font-size:21px;">Ir a la Portada</a>
</center>
</body>